SHADOWS



 P    W               W    W
 111111           1111111111 

          111111

     W               W
    1111111     1111111
             
 1                       1
 1 W         E         W 1