SWITCH



                   W     W
                1111111111111
       111111         
                 W         W
              111111111111111

  P      1   E     W      W     