FAIRYTALE

 

               W   E     W    E      W
            11111111111111111111111111111   
       W                                       W
   1111111                                  111111
               W           W          W
           11111111              1111111111           1
                            E   W                   1 1
                       1111111111                 1 1 1
                    1                    1      1 1 1
                    1                    1      1   
  P           1           E              1      1         