COLLAPSE
 
 
 
              W  E   W
           1111111111111 
                           W
    W                     11111
 111111       W        
          111111111
                      1         1
P                     1         1
              W       1E  W  E  1   W 