FAIRYTALE

 

               W   E     W    E      W
            11111111111111111111111111111   1
       W                                    1   W
   1111111                                  1  111
                                     W
                                  111111              1
                         W   E                      1 1
                       111111111                  1 1 1
                    1                    1      1 1 1
                    1                    1      1   
  P           1       1   E      1   E   1  W   1     W    