TWOWORLDS



                W                    W
           11111111111         1111111111111  

        W                  W                   W                  W
    1111111           111111111             1111111            1111111   
                                                                           
              W  E               E   W                E  W
            11111111          111111111111          1111111111    1 
                            1                     1               1 
        1                 1 1                   1 1             1 1  
        1                 1                     1               1
   P    1     E         E           E         E         E      